....................
..#..............#..
~~~..............~~~
.......~~~~~~.......
....................
...~~..........~~...
....................
~~................~~
..........#.........
.....#....~....#....
.....~...###...~....
....###.......###...
....................
.1..................
####################
