....................
....................
....................
.......++++++.......
....................
++++.............+++
....................
......++++++++......
...++...........++..
....................
....................
++++............++++
....................
.1..................
++++++++.....+++++++
