....................
.........+..........
//................//
....................
...//////////////...
....................
///......+.......///
.........+..........
...//..........//...
....................
///......+.......///
.........+..........
...//....+.....//...
.1..................
////////////////////
